时间段,股票个数,交易笔数,总成本,总收益,做对笔数,做错笔数,胜率,败率,收益率
2024-09-26 09:26:00,21,21,12422,702.0,16,5,76.19,23.81,5.65
2024-09-26 09:28:00,17,17,9737,636.0,13,4,76.47,23.53,6.53
2024-09-26 09:28:00,21,21,12422,702.0,16,5,76.19,23.81,5.65
2024-09-26 09:30:00,22,22,42364,1798.0,20,2,90.91,9.09,4.24
2024-09-26 09:31:00,25,25,59532,2465.0,23,2,92.0,8.0,4.14
2024-09-26 09:32:00,23,23,46271,2302.0,21,2,91.3,8.7,4.98
2024-09-26 09:35:00,24,24,38768,1718.0,21,3,87.5,12.5,4.43
2024-09-26 09:36:00,24,24,40189,1865.0,21,3,87.5,12.5,4.64
2024-09-26 09:38:00,28,28,52955,2382.0,25,3,89.29,10.71,4.5
2024-09-26 09:40:00,29,29,45594,1941.0,25,4,86.21,13.79,4.26
2024-09-26 09:42:00,31,31,51630,2148.0,26,5,83.87,16.13,4.16
2024-09-26 09:44:00,32,32,47175,1597.0,28,4,87.5,12.5,3.39
2024-09-26 09:46:00,32,32,48596,1871.0,30,2,93.75,6.25,3.85
2024-09-26 09:48:00,32,32,49552,1777.0,29,3,90.62,9.38,3.59
2024-09-26 09:50:00,33,33,50874,1477.0,26,7,78.79,21.21,2.9
2024-09-26 09:52:00,33,33,49007,1365.0,24,9,72.73,27.27,2.79
2024-09-26 09:54:00,32,32,50221,1378.0,23,9,71.88,28.12,2.74
2024-09-26 09:56:00,31,31,50024,1249.0,23,8,74.19,25.81,2.5
2024-09-26 09:58:00,31,31,48095,1228.0,25,6,80.65,19.35,2.55
2024-09-26 10:00:00,32,32,50455,1270.0,23,9,71.88,28.12,2.52
2024-09-26 10:03:00,33,33,51150,1504.0,25,8,75.76,24.24,2.94
2024-09-26 10:06:00,33,33,47339,1377.0,23,10,69.7,30.3,2.91
2024-09-26 10:09:00,32,32,45067,1105.0,22,10,68.75,31.25,2.45
2024-09-26 10:12:00,33,33,45968,1021.0,20,13,60.61,39.39,2.22
2024-09-26 10:14:00,25,25,35018,678.0,16,9,64.0,36.0,1.94
2024-09-26 10:15:00,33,33,45935,990.0,21,12,63.64,36.36,2.16
2024-09-26 10:18:00,33,33,45083,1132.0,23,10,69.7,30.3,2.51
2024-09-26 10:21:00,33,33,48499,1267.0,21,12,63.64,36.36,2.61
2024-09-26 10:24:00,33,33,48748,875.0,22,11,66.67,33.33,1.79
2024-09-26 10:27:00,33,33,48800,823.0,22,11,66.67,33.33,1.69
2024-09-26 10:28:00,24,24,34128,841.0,17,7,70.83,29.17,2.46
2024-09-26 10:30:00,33,33,46586,725.0,20,13,60.61,39.39,1.56
2024-09-26 10:33:00,33,33,45231,549.0,20,13,60.61,39.39,1.21
2024-09-26 10:36:00,34,34,45692,629.0,23,11,67.65,32.35,1.38
2024-09-26 10:39:00,34,34,46803,836.0,21,13,61.76,38.24,1.79
2024-09-26 10:42:00,33,33,44681,907.0,22,11,66.67,33.33,2.03
2024-09-26 10:45:00,32,32,41894,818.0,24,8,75.0,25.0,1.95
2024-09-26 10:48:00,32,32,43663,1000.0,24,8,75.0,25.0,2.29
2024-09-26 10:51:00,34,34,42622,1016.0,23,11,67.65,32.35,2.38
2024-09-26 10:54:00,32,32,41409,942.0,21,11,65.62,34.38,2.27
2024-09-26 10:57:00,33,33,45657,1060.0,23,10,69.7,30.3,2.32
2024-09-26 11:00:00,32,32,42844,996.0,21,11,65.62,34.38,2.32
2024-09-26 11:03:00,33,33,43707,896.0,22,11,66.67,33.33,2.05
2024-09-26 11:06:00,32,32,43386,856.0,20,12,62.5,37.5,1.97
2024-09-26 11:09:00,32,32,43376,866.0,20,12,62.5,37.5,2.0
2024-09-26 11:12:00,32,32,44680,662.0,19,13,59.38,40.62,1.48
2024-09-26 11:15:00,32,32,44442,610.0,19,13,59.38,40.62,1.37
2024-09-26 11:18:00,32,32,42855,680.0,20,12,62.5,37.5,1.59
2024-09-26 11:21:00,32,32,46557,544.0,19,13,59.38,40.62,1.17
2024-09-26 11:24:00,32,32,49384,494.0,18,14,56.25,43.75,1.0
2024-09-26 11:27:00,31,31,45394,796.0,21,10,67.74,32.26,1.75
2024-09-26 13:00:00,31,31,45056,907.0,23,8,74.19,25.81,2.01
2024-09-26 13:03:00,33,33,48352,1222.0,23,10,69.7,30.3,2.53
2024-09-26 13:06:00,33,33,47419,1114.0,21,12,63.64,36.36,2.35
2024-09-26 13:09:00,33,33,43498,885.0,23,10,69.7,30.3,2.03
2024-09-26 13:12:00,33,33,39703,881.0,22,11,66.67,33.33,2.22
2024-09-26 13:15:00,32,32,44805,1382.0,22,10,68.75,31.25,3.08
2024-09-26 13:18:00,32,32,43558,803.0,20,12,62.5,37.5,1.84
2024-09-26 13:21:00,32,32,43527,834.0,21,11,65.62,34.38,1.92
2024-09-26 13:24:00,32,32,44771,694.0,21,11,65.62,34.38,1.55
2024-09-26 13:27:00,33,33,47206,681.0,20,13,60.61,39.39,1.44
2024-09-26 13:30:00,33,33,46724,691.0,20,13,60.61,39.39,1.48
2024-09-26 13:33:00,33,33,58367,1338.0,21,12,63.64,36.36,2.29
2024-09-26 13:36:00,33,33,55474,1327.0,22,11,66.67,33.33,2.39
2024-09-26 13:39:00,32,32,59399,2322.0,24,8,75.0,25.0,3.91
2024-09-26 13:42:00,31,31,55004,1876.0,24,7,77.42,22.58,3.41
2024-09-26 13:45:00,31,31,59515,1916.0,25,6,80.65,19.35,3.22
2024-09-26 13:48:00,33,33,68165,1715.0,23,10,69.7,30.3,2.52
2024-09-26 13:51:00,34,34,68166,1482.0,22,12,64.71,35.29,2.17
2024-09-26 13:54:00,34,34,65842,1366.0,23,11,67.65,32.35,2.07
2024-09-26 13:57:00,35,35,66906,1003.0,18,17,51.43,48.57,1.5
2024-09-26 13:59:00,26,26,50305,1051.0,19,7,73.08,26.92,2.09
2024-09-26 14:00:00,34,34,65550,1114.0,20,14,58.82,41.18,1.7
2024-09-26 14:03:00,33,33,63955,1451.0,21,12,63.64,36.36,2.27
2024-09-26 14:06:00,32,32,61179,1513.0,22,10,68.75,31.25,2.47
2024-09-26 14:09:00,31,31,60493,1395.0,21,10,67.74,32.26,2.31
2024-09-26 14:12:00,32,32,63132,1248.0,21,11,65.62,34.38,1.98
2024-09-26 14:15:00,30,30,61926,1126.0,21,9,70.0,30.0,1.82
2024-09-26 14:18:00,31,31,60683,993.0,19,12,61.29,38.71,1.64
2024-09-26 14:21:00,26,26,52462,1027.0,16,10,61.54,38.46,1.96
2024-09-26 14:24:00,28,28,56247,345.0,12,16,42.86,57.14,0.61
2024-09-26 14:27:00,31,31,63560,365.0,15,16,48.39,51.61,0.57
2024-09-26 14:30:00,29,29,62724,573.0,14,15,48.28,51.72,0.91
2024-09-26 14:33:00,28,28,59766,912.0,14,14,50.0,50.0,1.53
2024-09-26 14:36:00,27,27,59131,773.0,15,12,55.56,44.44,1.31
2024-09-26 14:39:00,26,26,55499,549.0,11,15,42.31,57.69,0.99
2024-09-26 14:42:00,25,25,55547,183.0,8,17,32.0,68.0,0.33
2024-09-26 14:45:00,24,24,52764,130.0,8,16,33.33,66.67,0.25
2024-09-26 14:48:00,24,24,57489,-10.0,6,18,25.0,75.0,-0.02
2024-09-26 14:51:00,23,23,53576,2.0,6,17,26.09,73.91,0.0
2024-09-26 14:54:00,23,23,54886,48.0,7,16,30.43,69.57,0.09
2024-09-26 14:57:00,22,22,51067,11.0,4,18,18.18,81.82,0.02
